总挂牌房源,中介挂牌房源,个人挂牌房源,昨日住宅成交量,日期,周几
151391,147027,4364,329,2024-11-14,周四
151280,146919,4361,320.0,2024-11-13,周三
151122,146793,4329,345.0,2024-11-12,周二
150181,145931,4250,,2024-11-11,周一
150274,146027,4247,143.0,2024-11-10,周日
150398,146120,4278,465.0,2024-11-09,周六
150403,146104,4299,312.0,2024-11-08,周五
150419,146073,4346,352.0,2024-11-07,周四
150296,145941,4355,345.0,2024-11-05,周二
150378,146000,4378,328.0,2024-10-30,周三
