总挂牌房源,中介挂牌房源,个人挂牌房源,昨日住宅成交量,日期,周几
149357,144101,5256,,2025-04-20,周日
148223,143159,5064,159.0,2025-04-19,周六
148727,143667,5060,401.0,2025-04-17,周四
148398,143378,5020,410.0,2025-04-16,周三
148071,143095,4976,413.0,2025-04-15,周二
147822,142905,4917,420.0,2025-04-14,周一
147406,142516,4890,,2025-04-13,周日
146616,141883,4733,182.0,2025-04-12,周六
146743,142010,4733,491.0,2025-04-11,周五
146620,141902,4718,404.0,2025-04-10,周四
146282,141616,4666,399.0,2025-04-09,周三
145956,141323,4633,401.0,2025-04-08,周二
145701,141136,4565,360.0,2025-04-07,周一
145114,140629,4485,,2025-04-06,周日
143768,139423,4345,,2025-04-05,周六
143832,139491,4341,,2025-04-04,周五
143917,139577,4340,478.0,2025-04-03,周四
143847,139512,4335,401.0,2025-04-02,周三
143159,138867,4292,331.0,2025-04-01,周二
142549,138297,4252,421.0,2025-03-31,周一
141986,137805,4181,,2025-03-30,周日
141159,137129,4030,172.0,2025-03-29,周六
141059,137027,4032,489.0,2025-03-28,周五
140679,136670,4009,367.0,2025-03-27,周四
140400,136435,3965,387.0,2025-03-26,周三
140105,136191,3914,376.0,2025-03-25,周二
139865,136006,3859,414.0,2025-03-24,周一
139436,135624,3812,,2025-03-23,周日
138293,134638,3655,156.0,2025-03-22,周六
138392,134743,3649,506.0,2025-03-21,周五
138263,134641,3622,359.0,2025-03-20,周四
138365,134696,3669,389.0,2025-03-19,周三
138462,134792,3670,439.0,2025-03-18,周二
138752,135048,3704,409.0,2025-03-17,周一
138581,134831,3750,,2025-03-16,周日
138257,134523,3734,163.0,2025-03-15,周六
138708,134891,3817,478.0,2025-03-14,周五
139243,135383,3860,396.0,2025-03-13,周四
139315,135426,3889,388.0,2025-03-12,周三
139336,135432,3904,429.0,2025-03-11,周二
139308,135391,3917,464.0,2025-03-10,周一
139252,135300,3952,,2025-03-09,周日
138725,134891,3834,159.0,2025-03-08,周六
139207,135301,3906,431.0,2025-03-07,周五
139435,135486,3949,381.0,2025-03-06,周四
139537,135570,3967,355.0,2025-03-05,周三
139489,135498,3991,327.0,2025-03-04,周二
139599,135603,3996,324.0,2025-03-03,周一
139412,135360,4052,,2025-03-02,周日
138945,135064,3881,165.0,2025-03-01,周六
139420,135480,3940,432.0,2025-02-28,周五
140491,136330,4161,297.0,2025-02-27,周四
140520,136318,4202,389.0,2025-02-26,周三
140431,136204,4227,309.0,2025-02-25,周二
140497,136225,4272,337.0,2025-02-24,周一
140345,136045,4300,,2025-02-23,周日
139757,135607,4150,106.0,2025-02-22,周六
140207,135984,4223,373.0,2025-02-21,周五
140369,136076,4293,282.0,2025-02-20,周四
140365,136104,4261,243.0,2025-02-19,周三
140225,135975,4250,277.0,2025-02-18,周二
140309,136047,4262,262.0,2025-02-17,周一
139782,135499,4283,,2025-02-16,周日
139799,135644,4155,131.0,2025-02-15,周六
140199,136004,4195,315.0,2025-02-14,周五
140383,136158,4225,218.0,2025-02-13,周四
140378,136139,4239,192.0,2025-02-12,周三
140412,136162,4250,212.0,2025-02-11,周二
140526,136249,4277,242.0,2025-02-10,周一
140401,136144,4257,,2025-02-09,周日
140304,136087,4217,187.0,2025-02-08,周六
140566,136311,4255,218.0,2025-02-07,周五
140521,136267,4254,217.0,2025-02-06,周四
140396,136150,4246,162.0,2025-02-05,周三
140383,136122,4261,,2025-02-04,周二
140549,136244,4305,,2025-02-03,周一
140797,136459,4338,,2025-02-02,周日
141061,136683,4378,,2025-02-01,周六
141310,136885,4425,,2025-01-31,周五
141717,137251,4466,,2025-01-30,周四
141983,137465,4518,,2025-01-29,周三
142190,137612,4578,,2025-01-28,周二
142368,137731,4637,94.0,2025-01-27,周一
142628,137936,4692,197.0,2025-01-26,周日
142875,138131,4744,9.0,2025-01-25,周六
143095,138325,4770,353.0,2025-01-24,周五
143362,138542,4820,362.0,2025-01-23,周四
143687,138808,4879,401.0,2025-01-22,周三
144150,139147,5003,437.0,2025-01-20,周一
144325,139305,5020,,2025-01-19,周日
144197,139232,4965,159.0,2025-01-18,周六
144534,139533,5001,506.0,2025-01-17,周五
144774,139734,5040,389.0,2025-01-16,周四
145048,139971,5077,423.0,2025-01-15,周三
145154,140059,5095,321.0,2025-01-14,周二
145356,140249,5107,379.0,2025-01-13,周一
145513,140395,5118,,2025-01-12,周日
145217,140190,5027,174.0,2025-01-11,周六
145626,140550,5076,470.0,2025-01-10,周五
145851,140740,5111,368.0,2025-01-09,周四
145944,140783,5161,377.0,2025-01-08,周三
145968,140767,5201,373.0,2025-01-07,周二
145962,140759,5203,383.0,2025-01-06,周一
145947,140771,5176,,2025-01-05,周日
145634,140568,5066,143.0,2025-01-04,周六
146046,140960,5086,544.0,2025-01-03,周五
146319,141235,5084,573.0,2025-01-02,周四
146400,141358,5042,,2025-01-01,周三
146426,141438,4988,,2024-12-31,周二
147880,142911,4969,,2024-12-30,周一
148198,143276,4922,,2024-12-29,周日
148052,143188,4864,,2024-12-28,周六
148542,143656,4886,637.0,2024-12-27,周五
149086,144178,4908,523.0,2024-12-26,周四
149494,144566,4928,421.0,2024-12-25,周三
149755,144811,4944,400.0,2024-12-24,周二
149955,144997,4958,433.0,2024-12-23,周一
150303,145332,4971,,2024-12-22,周日
151962,147086,4876,403.0,2024-12-19,周四
152222,147347,4875,447.0,2024-12-18,周三
152353,147499,4854,402.0,2024-12-17,周二
152376,147543,4833,504.0,2024-12-16,周一
152094,147330,4764,,2024-12-15,周日
151530,146876,4654,181.0,2024-12-14,周六
152102,147427,4675,555.0,2024-12-13,周五
152341,147642,4699,407.0,2024-12-12,周四
152380,147707,4673,390.0,2024-12-11,周三
152450,147765,4685,405.0,2024-12-10,周二
152458,147795,4663,435.0,2024-12-09,周一
151798,147264,4534,,2024-12-08,周日
152068,147516,4552,212.0,2024-12-07,周六
152414,147830,4584,577.0,2024-12-06,周五
152630,148006,4624,415.0,2024-12-05,周四
152713,148079,4634,485.0,2024-12-04,周三
152745,148099,4646,593.0,2024-12-03,周二
152653,147990,4663,950.0,2024-12-02,周一
152875,148157,4718,,2024-12-01,周日
152097,147517,4580,97.0,2024-11-30,周六
152732,148081,4651,341.0,2024-11-29,周五
152753,148098,4655,283.0,2024-11-28,周四
152615,147992,4623,328.0,2024-11-27,周三
152681,148064,4617,232.0,2024-11-26,周二
152441,147854,4587,294.0,2024-11-25,周一
152636,148022,4614,0.0,2024-11-24,周日
152080,147645,4435,110.0,2024-11-23,周六
152200,147746,4454,362.0,2024-11-22,周五
152087,147693,4394,264.0,2024-11-21,周四
151990,147585,4405,252.0,2024-11-20,周三
151882,147425,4457,269.0,2024-11-19,周二
152029,147557,4472,279.0,2024-11-18,周一
151008,146674,4334,0.0,2024-11-17,周日
151356,146992,4364,108.0,2024-11-16,周六
151572,147174,4398,389.0,2024-11-15,周五
151716,147298,4418,300.0,2024-11-14,周四
151391,147027,4364,329.0,2024-11-13,周三
151280,146919,4361,320.0,2024-11-12,周二
151122,146793,4329,345.0,2024-11-11,周一
