总挂牌房源,中介挂牌房源,个人挂牌房源,昨日住宅成交量,日期,周几
151716,147298,4418,300,2024-11-14,周四
151391,147027,4364,329,2024-11-13,周三
151280,146919,4361,320,2024-11-12,周二
151122,146793,4329,345,2024-11-11,周一
150181,145931,4250,320,2024-11-10,周日
150274,146027,4247,143,2024-11-09,周六
150398,146120,4278,465,2024-11-08,周五
150403,146104,4299,312,2024-11-07,周四
150419,146073,4346,352,2024-11-06,周三
150296,145941,4355,345,2024-11-04,周一
150378,146000,4378,328,2024-10-29,周二
